############
#    #     #
# $$ #  .  #
#  $   .   #
# .  ##    #
#    A @   #
#    ##    #
#          #
############
