    #######
  ###     ####
 ##@F        ###
####           ##
#   $ # $ # $   #
#     #   #     #
### . # . # . ###
  #           #
  #############
