##############
#  $$  #     #
# #### # # . #
# #    A # . #
# # #### #   #
# #      #####
# @ #########
##############