###################
#                 #
#   ###########   #
#  ##         ##  #
# #.#X $ @ $ X#.# #
#  ##         ##  #
#   ###########   #
#                 #
###################