##########
#        #
#   T  # #
#   .  # #
######## #
#@       #
#   $    #
#    T   #
##########
