##############
#          ? #
#    @       #
#   ######   #
#...#    #   #
##### $  #   #
#   # $      #
# $ ######   #
#   ?   ?    #
##########   #
         #####